+-+-+-+-+-+-+-+
|$    |       |
+ +-+ +       +
|   |-|       |
+           +
|             |
+             +
|             |
+            F+
|             |
+             +
|             |
+-+-+-+-+-+-+-+